#######A########
#  #: # +      #
# ### #### ### #
# #   #      # #
# # ######## # #
#              #
# #:### ###:## #
# ###    ##### #
#              #
### #     #### #
#   :#    #:   #
################