#######A########
#:#   #+#    #:#
#   #     ##   #
# # # ###### # #
# # # #:     # #
# # # #  # # # #
# # # #  # # # #
# #     :# # # #
# # ###### # # #
#          #   #
#:# ######   #:#
################