#######A########
#     #+#      #
#   # # # :##  #
#   # # #      #
# ###   # #### #
#     #   #    #
# #:### #  :## #
# ###:# ###### #
#              #
### #### ### ###
#:            :#
################