#######A########
#             :#
# # # #  # # # #
#  :           #
# # # #  # # # #
#    : +       #
# # # #  # # # #
#         :    #
# # # #  # # # #
#           :  #
#:# # #  # # # #
################